48 48 48 48 48 48 48 48 48 48 48 48 48 48 48 48 48
48 48 48 48 48 48 48 48 48 48 48 48 48 48 48 48 48
48 48 48 48 48 48 48 48 48 48 48 48 48 48 48 48 48
48 48 48 48 48 4  26 26 26 26 5  48 48 48 48 48 48
48 48 48 48 48 15 0  0  0  0  13 48 48 48 48 48 48
48 48 48 48 48 15 0  0  0  0  13 48 48 48 48 48 48
48 48 48 48 48 15 0  0  0  0  13 48 48 48 48 48 48
48 48 48 48 48 15 0  0  0  0  13 48 48 48 48 48 48
48 48 48 48 48 16 2  2  2  2  17 48 48 48 48 48 48
48 48 48 48 48 57 14 14 14 14 59 48 48 48 48 48 48
48 48 48 48 48 51 50 50 51 50 51 48 48 48 48 48 48
48 48 48 48 48 48 48 48 48 48 48 48 48 48 48 48 48
48 48 48 48 48 48 48 48 48 48 48 48 48 48 48 48 48
48 48 48 48 48 48 48 48 48 48 48 48 48 48 48 48 48
48 48 48 48 48 48 48 48 48 48 48 48 48 48 48 48 48
