25 25 25 25 25 25 25 25 25 25 25 25 25 25 25 25 25
25 25 25 25 25 25 25 25 25 25 25 25 25 25 25 25 25
25 25 25 25 25 25 25 25 25 25 25 25 25 25 25 25 25
25 25 25 25 25 6  7  7  7  7  8  25 25 25 25 25 25
25 25 25 25 25 16 17 17 17 17 18 25 25 25 25 25 25
25 25 25 25 25 16 17 17 17 17 18 25 25 25 25 25 25
25 25 25 25 25 16 17 17 17 17 18 25 25 25 25 25 25
25 25 25 25 25 16 17 17 17 17 18 25 25 25 25 25 25
25 25 25 25 25 16 17 17 17 17 18 25 25 25 25 25 25
25 25 25 25 25 26 27 27 27 27 28 25 25 25 25 25 25
25 25 25 25 25 36 37 37 37 37 38 25 25 25 25 25 25
25 25 25 25 25 46 47 47 47 47 48 25 25 25 25 25 25
25 25 25 25 25 25 25 25 25 25 25 25 25 25 25 25 25
25 25 0  25 25 25 25 25 25 25 25 25 25 25 25 25 25
25 25 25 25 25 25 25 25 25 25 25 25 25 25 25 25 25
